#########
#_L____##
##ES_####
#EC__#S_S
#E_S_L__S
##_SSS###
#___L___#
#########