#########
#______##
##EE_####
#E___#S_S
#E_S____S
##_SSS###
#_______#
#########